const map = [
    [0,0,0,0,0,0,0,0,0,0,0,0,0,0,0,0],
    [0,1,1,1,1,1,1,3,2,2,3,1,1,1,1,0],
    [0,1,1,1,1,1,1,3,2,2,3,1,1,1,1,0],
    [0,1,1,1,1,1,1,3,2,2,3,1,1,1,1,0],
    [0,1,1,1,1,1,1,3,2,2,3,1,1,1,1,0],
    [0,1,1,1,1,1,1,3,2,2,3,1,1,1,1,0],
    [0,1,1,1,1,1,1,3,2,2,3,1,1,1,1,0],
    [0,1,1,1,1,1,1,1,3,2,2,3,1,1,1,0],
    [0,1,1,1,1,1,1,3,2,2,3,1,1,1,1,0],
    [0,1,1,1,1,1,3,2,2,3,1,1,1,1,1,0],
    [0,1,1,1,1,1,1,3,2,2,3,1,1,1,1,0],
    [0,1,1,1,1,1,1,3,2,2,3,1,1,1,1,0],
    [0,1,1,1,1,1,1,3,2,2,3,1,1,1,1,0],
    [0,1,1,1,1,1,1,3,2,2,3,1,1,1,1,0],
    [0,1,1,1,1,1,1,3,2,2,3,1,1,1,1,0],
    [0,,0,0,0,0,0,0,0,0,0,0,0,0,0,0,0]

]

const map = [
    [5, 1, 1, 1, 1, 3, 1, 1, 0, 4, 1, 1, 3, 2, 2, 2],
    [0, 1, 1, 1, 3, 2, 3, 1, 0, 1, 1, 1, 3, 2, 2, 2],
    [0, 1, 1, 1, 1, 3, 1, 1, 0, 1, 1, 1, 3, 3, 2, 2],
    [0, 0, 1, 1, 1, 1, 1, 1, 0, 1, 1, 1, 1, 3, 2, 2],
    [0, 0, 0, 1, 1, 1, 1, 1, 0, 0, 1, 1, 1, 1, 3, 3],
    [2, 3, 0, 1, 1, 1, 1, 1, 0, 0, 1, 1, 1, 1, 1, 1],
    [2, 3, 3, 1, 1, 1, 1, 1, 0, 0, 0, 1, 1, 1, 1, 1],
    [2, 3, 1, 1, 1, 1, 1, 0, 0, 0, 0, 0, 0, 0, 1, 1],
    [2, 3, 0, 1, 1, 1, 1, 0, 0, 0, 0, 3, 3, 1, 1, 1],
    [2, 3, 0, 1, 1, 1, 1, 0, 0, 0, 3, 3, 1, 1, 1, 1],
    [2, 3, 0, 1, 1, 1, 1, 0, 0, 3, 1, 1, 1, 1, 1, 1],
    [2, 3, 0, 3, 1, 1, 1, 0, 3, 1, 1, 1, 1, 1, 1, 1],
    [2, 3, 0, 2, 3, 1, 1, 0, 3, 1, 1, 1, 1, 1, 1, 1],
    [2, 3, 0, 2, 2, 3, 1, 3, 1, 1, 1, 1, 1, 1, 1, 1],
    [2, 0, 0, 2, 2, 3, 1, 1, 1, 1, 1, 1, 1, 1, 1, 1],
    [1, 1, 1, 1, 1, 1, 1, 1, 1, 1, 1, 1, 1, 1, 1, 1],
    [0, 0, 0, 0, 2, 3, 1, 1, 1, 1, 1, 1, 1, 1, 1, 1],

]

//Colores
const grassC = "#4aa127e8"
const waterC = "#2189deec"
const rockC = "#4d4c4cfc"
const landC = "#daad34"
const keyC = "#edea3e"
const doorC = "#8b7115"

const rock = 0
const grass = 1
const water = 2
const land = 3
const key = 4
const door = 5