{
    "id":1,
    "mapName":"Inferno Dungeons",
    "history":"You decided to enter the Inferno Dungeons to 'save the world' How noble! What they didn't tell you is that it smells like sulfur, it's unbearably hot, and everything here wants to kill you. By the way, why does this fortress need three books to open a single portal? Demon architects are really something else.",
    "mapCoords":[
    [4, 4, 4, 4, 4, 4, 5, 5, 4, 4, 4, 5, 5, 5, 5, 5, 4, 4, 4, 4, 5, 5, 5, 5, 5, 5, 5, 5, 5, 5, 4, 4, 4],
    [4, 4, 0, 4, 4, 0, 0, 5, 5, 5, 4, 4, 4, 4, 4, 0, 0, 4, 0, 0, 0, 0, 0, 0, 0, 0, 0, 0, 0, 4, 4, 4, 4],
    [4, 4, 0, 4, 0, 0, 0, 0, 0, 5, 4, 4, 0, 4, 4, 0, 0, 0, 0, 0, 0, 0, 0, 0, 0, 0, 0, 4, 0, 0, 4, 4, 4],
    [0, 0, 0, 0, 0, 0, 0, 0, 0, 5, 4, 0, 4, 4, 0, 0, 0, 0, 0, 0, 5, 0, 0, 0, 0, 0, 0, 0, 0, 0, 0, 4, 4],
    [5, 0, 0, 0, 0, 0, 0, 0, 0, 5, 0, 0, 0, 0, 0, 0, 0, 0, 0, 0, 5, 5, 5, 0, 0, 0, 0, 0, 0, 0, 4, 4, 4],
    [5, 0, 0, 0, 0, 0, 4, 0, 0, 5, 4, 0, 0, 0, 0, 0, 0, 0, 0, 0, 5, 5, 0, 0, 0, 0, 0, 0, 4, 4, 4, 4, 4],
    [5, 4, 0, 0, 0, 0, 4, 4, 0, 5, 0, 0, 0, 0, 4, 0, 0, 0, 0, 0, 5, 0, 0, 0, 0, 0, 0, 0, 0, 4, 4, 4, 4],
    [4, 4, 0, 0, 0, 4, 4, 4, 4, 5, 0, 0, 0, 0, 4, 4, 4, 0, 0, 0, 5, 0, 0, 0, 0, 0, 0, 0, 0, 4, 4, 4, 4],
    [4, 0, 0, 0, 0, 0, 4, 0, 0, 5, 0, 0, 0, 4, 4, 0, 4, 4, 4, 0, 5, 0, 0, 0, 0, 0, 0, 0, 0, 0, 4, 4, 4],
    [4, 0, 0, 0, 0, 0, 0, 0, 0, 5, 0, 0, 0, 0, 4, 4, 4, 4, 4, 0, 5, 0, 0, 0, 0, 0, 0, 0, 0, 0, 4, 4, 4],
    [5, 0, 0, 0, 0, 0, 0, 0, 5, 5, 0, 0, 0, 0, 4, 4, 4, 0, 0, 0, 5, 0, 0, 0, 0, 0, 0, 0, 4, 4, 0, 4, 4],
    [5, 0, 0, 0, 0, 0, 0, 5, 5, 5, 0, 0, 0, 0, 0, 4, 0, 0, 0, 0, 5, 0, 0, 0, 0, 0, 0, 4, 4, 0, 0, 0, 4],
    [4, 0, 0, 0, 0, 0, 0, 5, 0, 0, 0, 0, 0, 0, 0, 0, 0, 0, 0, 0, 5, 5, 0, 0, 0, 0, 0, 4, 0, 0, 0, 0, 4],
    [4, 4, 0, 0, 0, 0, 0, 0, 0, 0, 0, 0, 0, 0, 0, 0, 0, 0, 0, 0, 0, 5, 5, 0, 0, 4, 0, 0, 0, 0, 0, 0, 4],
    [4, 4, 0, 0, 0, 0, 0, 0, 0, 0, 0, 0, 0, 5, 0, 0, 0, 0, 0, 0, 0, 0, 0, 0, 0, 0, 0, 0, 0, 0, 0, 0, 4],
    [4, 4, 4, 0, 4, 5, 0, 0, 0, 0, 0, 0, 5, 4, 5, 5, 0, 0, 0, 0, 0, 0, 0, 0, 0, 0, 0, 0, 0, 0, 0, 4, 4],
    [4, 4, 4, 4, 4, 4, 5, 5, 5, 5, 5, 5, 4, 4, 4, 5, 5, 5, 5, 5, 5, 5, 5, 5, 5, 5, 5, 5, 5, 5, 4, 4, 4]
    ],
    "structuresCode":[
        {"code":5, "name":"wall"},
        {"code":0, "name":"floor"},
        {"code":4, "name":"lava"}
    ],
    "playerStart":{"gridX": 2, "gridY":3},
    "playerMovList":[0],
    "enemies":[
        {"type": "devil", "range":4, "time":20,"walkableStructures":[0],"coords":[{"gridX":3,"gridY":10}]},
        {"type": "skull", "range":7, "time":15,"walkableStructures":[0,4],"coords":[{"gridX":16,"gridY":11}]},
        {"type": "slime", "range":6, "time":30,"walkableStructures":[0],"coords":[{"gridX":24,"gridY":6}]}
    ],
    "keysCoords":[
        {"gridX":8,"gridY":5},
        {"gridX":17,"gridY":13},
        {"gridX":25,"gridY":7}
    ],
    "doorsCoords":[{"gridX":2,"gridY":1}]
}