{
    "id":2,
    "mapName":"Paradise",
    "history":"Incomplete",
    "mapCoords":[
    [4, 4, 4, 4, 4, 4, 4, 4, 4, 4, 4, 4, 4, 4, 4, 4, 4, 4, 4, 4, 4, 4, 4, 4, 4, 4, 4, 4, 4, 4, 4, 4, 4],
    [4, 4, 3, 4, 4, 3, 3, 3, 3, 3, 4, 4, 4, 4, 4, 3, 3, 3, 3, 3, 3, 3, 3, 3, 3, 3, 3, 3, 3, 4, 4, 4, 4],
    [4, 4, 3, 3, 3, 3, 0, 0, 0, 3, 4, 3, 3, 4, 4, 3, 0, 0, 0, 0, 0, 0, 0, 0, 0, 0, 0, 4, 3, 3, 4, 4, 4],
    [4, 4, 3, 3, 3, 0, 0, 0, 0, 3, 4, 3, 3, 4, 5, 5, 5, 0, 0, 0, 0, 0, 0, 0, 0, 0, 0, 0, 0, 3, 3, 4, 4],
    [4, 4, 3, 3, 3, 0, 0, 0, 5, 5, 5, 5, 5, 5, 5, 1, 5, 0, 0, 0, 0, 0, 0, 0, 0, 0, 0, 0, 3, 3, 4, 4, 4],
    [4, 4, 3, 3, 0, 0, 4, 5, 5, 1, 1, 1, 1, 1, 1, 1, 5, 0, 0, 0, 0, 0, 0, 0, 0, 0, 0, 0, 3, 4, 4, 4, 4],
    [4, 4, 3, 3, 0, 0, 4, 5, 1, 1, 1, 1, 1, 1, 1, 1, 5, 0, 0, 0, 0, 0, 0, 0, 0, 0, 0, 0, 3, 4, 4, 4, 4],
    [4, 4, 3, 0, 0, 4, 4, 5, 4, 1, 1, 1, 1, 1, 1, 1, 1, 5, 0, 0, 0, 0, 0, 0, 0, 0, 0, 0, 3, 4, 4, 4, 4],
    [4, 4, 3, 3, 0, 0, 4, 5, 5, 5, 1, 1, 1, 1, 1, 1, 1, 5, 4, 0, 0, 0, 0, 0, 0, 0, 0, 0, 0, 3, 4, 4, 4],
    [4, 4, 4, 3, 0, 0, 0, 0, 0, 5, 1, 1, 1, 1, 1, 1, 1, 5, 4, 0, 0, 0, 0, 0, 0, 0, 0, 0, 0, 3, 4, 4, 4],
    [4, 4, 4, 3, 0, 0, 0, 0, 0, 0, 5, 5, 5, 1, 1, 1, 5, 0, 0, 0, 0, 0, 0, 0, 0, 0, 0, 0, 4, 3, 3, 4, 4],
    [4, 4, 4, 3, 0, 0, 0, 0, 0, 0, 0, 0, 0, 5, 1, 5, 0, 0, 0, 0, 0, 0, 0, 0, 0, 0, 0, 1, 4, 0, 3, 3, 4],
    [4, 4, 4, 3, 0, 0, 0, 0, 0, 0, 0, 0, 0, 0, 0, 0, 0, 0, 0, 0, 0, 0, 0, 0, 0, 0, 0, 1, 0, 0, 0, 3, 4],
    [4, 4, 4, 3, 0, 0, 0, 0, 0, 0, 0, 0, 0, 0, 0, 0, 0, 0, 0, 0, 0, 0, 0, 0, 0, 1, 0, 0, 0, 0, 0, 3, 4],
    [4, 4, 4, 3, 0, 0, 0, 0, 0, 0, 0, 0, 0, 0, 0, 0, 0, 0, 0, 0, 0, 0, 0, 0, 0, 0, 0, 0, 0, 0, 3, 3, 4],
    [4, 4, 4, 3, 4, 0, 0, 0, 0, 0, 0, 0, 0, 4, 0, 0, 0, 0, 0, 0, 0, 0, 0, 0, 0, 0, 0, 0, 0, 0, 3, 4, 4],
    [4, 4, 4, 4, 4, 4, 4, 4, 4, 4, 4, 4, 4, 4, 4, 4, 4, 4, 4, 4, 4, 4, 4, 4, 4, 4, 4, 4, 4, 4, 4, 4, 4]
    ],
    "structuresCode":[
        {"code":0, "name":"grass"},
        {"code":1, "name":"beautifulgrass"},
        {"code":3, "name":"sand"},
        {"code":4, "name":"cleanWater"},
        {"code":5, "name":"rockWall"}
    ],
    "playerStart":{"gridX": 2, "gridY":3},
    "playerMovList":[0],
    "enemies":[
        {"type": "crab", "range":4, "time":30,"walkableStructures":[0],"coords":[{"gridX":3,"gridY":10}]},
        {"type": "minotaur", "range":5, "time":20,"walkableStructures":[0],"coords":[{"gridX":16,"gridY":11}]},
        {"type": "slime", "range":6, "time":35,"walkableStructures":[0],"coords":[{"gridX":24,"gridY":6}]}
    ],
    "keysCoords":[
        {"gridX":8,"gridY":5},
        {"gridX":17,"gridY":13},
        {"gridX":25,"gridY":7}
    ],
    "doorsCoords":[{"gridX":2,"gridY":1}]
}